####### ######
####### ### ##
#####s# ### ##
####### ###e##
# e ### ### ##
####### ######
####### ###s##
####### ######
#####  p  ####
##############
#s############
##############
#######  E  ##
### ##########
### ##########
###e##########
### ##########
##############