####### ######
####### ### ##
#####s# ### ##
####### ### ##
#   ### ### ##
####### ######
####### ######
####### ######
#####  p  ####
##############
#s##########s#
##############
#######     ##
### ##########
### ##########
### ##########
### ##########
##############